11111111
101C00P1
10011001
111E0001
11111111