1111111111111
10000001000C1
1010000011001
1P1011E000001
1111111111111