11111111
100C00P1
10110111
111E1111
11111111