1111111
1100P01
1111101
1E100C1
1111111