1111111
110CP11
1111001
1E11111
1111111