1111111
11C1P01
11E1101
1100001
1111111