1111111
11C1P01
1100001
110E101
1111111