11111111
11C1P101
110E0111
11000001
11111111
