11111111
1C1001P1
100E0001
11111111
