11111111
100CCCP1
10001011
111E1111
11111111