11111111
11C1P0C1
11000001
110E1001
11111111