1111111111111
10010C0000001
1110011101101
1P1011E000011
1111111111111