1111111
11C0P11
1111101
1E00011
1111111